2 2 2 2 2 2 2 2 2 2 2 2 2 2 2 2 2 2 2 2 2 2 2 2 2 2 2 2 2 2 2 2 2 2 2 2 2 2 2 2
2 0 4 0 0 4 0 0 3 0 4 0 0 0 1 0 3 0 0 0 5 0 4 0 3 5 0 0 0 0 0 0 3 0 0 4 4 0 0 2
2 0 0 0 0 0 0 0 3 0 0 0 0 0 0 5 3 5 5 0 5 0 0 0 3 5 0 0 5 0 0 0 3 0 0 0 0 5 0 2
2 5 5 5 5 5 5 5 5 5 5 5 5 5 5 4 5 4 4 5 5 5 5 5 5 4 5 5 1 5 5 5 5 5 5 5 5 4 5 2
2 1 0 0 0 0 0 0 3 0 4 0 0 0 0 4 3 0 4 0 5 0 0 5 3 0 0 4 0 0 1 0 3 0 0 4 0 4 0 2
2 0 0 0 0 0 0 0 3 0 4 0 0 0 0 4 3 0 0 0 5 5 0 0 3 0 0 0 0 0 4 0 3 0 0 0 5 0 0 2
2 3 3 3 3 3 3 3 3 3 3 3 3 3 3 3 3 3 3 3 5 3 3 3 3 3 3 3 3 3 3 3 3 3 3 3 3 3 3 2
2 0 0 0 0 4 4 0 3 0 0 5 0 0 0 0 3 0 0 0 5 0 0 0 3 0 0 0 0 5 0 0 3 0 0 0 0 0 5 2
2 0 0 0 0 0 0 0 3 0 0 5 0 0 0 0 3 0 0 0 5 0 0 0 3 0 0 0 0 4 0 5 3 0 0 0 0 0 4 2
2 5 5 5 5 5 5 5 5 5 5 4 5 5 5 5 5 5 5 5 5 5 5 5 5 5 5 5 5 4 5 5 5 5 5 5 5 5 4 2
2 4 0 0 4 0 0 0 3 0 0 0 0 1 0 0 3 0 0 4 5 0 0 0 3 0 0 0 0 0 0 1 3 5 0 0 0 0 0 2
2 4 0 0 0 0 4 0 3 0 0 4 0 0 4 0 3 0 0 0 5 0 5 5 3 0 0 0 0 0 0 0 3 4 0 0 0 1 0 2
2 0 4 0 0 0 0 0 3 0 0 0 4 0 0 0 3 0 0 0 5 0 4 4 3 0 0 0 0 0 0 0 3 4 4 0 0 4 0 2
2 3 3 3 3 3 3 3 3 3 3 3 3 3 3 3 3 3 3 3 5 3 3 3 3 3 3 3 3 3 3 3 3 3 3 3 3 3 3 2
2 4 0 5 5 5 0 0 3 0 0 0 0 4 0 4 3 0 0 0 5 0 0 0 3 0 4 1 0 0 4 0 3 0 0 0 0 0 0 2
2 0 0 0 0 0 5 0 3 5 0 0 0 0 0 0 3 0 0 5 5 0 0 0 3 0 0 0 5 0 0 0 3 0 5 0 5 5 0 2
2 5 5 5 5 5 5 5 5 1 5 5 5 5 5 5 5 5 5 1 5 5 5 5 5 5 5 5 4 5 5 5 5 5 1 5 4 4 5 2
2 1 0 0 5 0 4 0 3 4 0 0 0 0 4 0 3 0 4 0 5 0 0 4 3 0 4 0 4 0 0 0 3 0 0 0 0 0 0 2
2 0 0 0 0 0 4 0 3 4 0 0 1 0 0 0 3 0 0 0 5 5 0 0 3 0 0 4 0 0 0 0 3 0 0 0 5 5 5 2
2 0 1 0 0 0 4 5 3 0 0 5 0 0 0 0 3 0 5 0 4 4 0 0 3 0 5 0 0 0 0 0 3 0 0 0 4 4 4 2
2 0 4 0 0 0 0 4 3 0 0 4 0 0 4 0 3 6 8 0 4 0 0 0 3 0 0 0 0 4 0 4 3 0 0 0 0 4 0 2
2 2 2 2 2 2 2 2 2 2 2 2 2 2 2 2 2 2 2 2 2 2 2 2 2 2 2 2 2 2 2 2 2 2 2 2 2 2 2 2